1111111111111
10010000001C1
1000011100111
1P00111E11111
1111111111111